2,1,2,1,2,1,2
0,0,3,4,4,5,0
1,2,1,2,1,2,1
0,0,0,0,0,0,0
2,1,2,1,2,1,2
0,0,0,0,0,0,0
1,2,1,2,1,2,1
0,0,0,0,0,0,0
2,1,2,1,2,1,2
0,0,0,0,0,0,0
1,2,1,2,1,2,1
0,0,0,0,0,0,0
2,1,2,1,2,1,2